NNNNNNNNNNNNNNNNNNNNNNNNNNNNNN
NNNNNNNNNNNNNNNNNNNNNNNNNNNNNN
NNNNNNNNNNNNNNNNNNNNNNNNNNNNNN
NNNNNNNNNNNNNNNNNNNNNNNNNNNNNN
NNNNNNNNNNNNNNNNNNNNNNNNNNNNNN
NNNNNNNNNNFFFVFFFFFFNNNNNNNNNN
NNNNNNNNNNFFFFFFFFFFNNNNNNNNNN
NNNNNNNNNNFFFFFFFFFFNNNNNNNNNN
NNNNNNNNNNFFFFFFAFFFNNNNNNNNNN
NNNNNNNNNNFFFFFFFFFFNNNNNNNNNN
NNNNNNNNNNFFFFFFFFFFNNNNNNNNNN
NNNNNNNNNNFFFFFFFFFFNNNNNNNNNN
NNNNNNNNNNFFBFFFFFFFNNNNNNNNNN
NNNNNNNNNNFFFFFFFFFFNNNNNNNNNN
NNNNNNNNNNFFFFFFFFFFNNNNNNNNNN
NNNNNNNNNNNNNmNNNNNNNNNNNNNNNN
NNNNNNNNNNNNNNNNNNNNNNNNNNNNNN
NNNNNNNNNNNNNNNNNNNNNNNNNNNNNN
NNNNNNNNNNNNNNNNNNNNNNNNNNNNNN
NNNNNNNNNNNNNNNNNNNNNNNNNNNNNN