TTTTTTTTTTTTTTssTTTTTTTTTTTTTT
T                            T
T                            T
T                            T
T  HHHH                HHHH  T
T  HHHH                HHHH  T
T  HHHH                HHHH  T
T  HlHH                HhHH  T
T          HHHHHHH           T
T          HHHHHHH           T
T          HHHHHHH           T
T          HHHoHHH           T
T  HHHH                HHHH  T
T  HHHH                HHHH  T
T  HHHH                HHHH  T
T  HlHH                HHcH  T
T                            T
T                            T
T                            T
TTTTTTTTTTTTTTTTTTTTTTTTTTTTTT
