LLLLLLLLLLLLLLLLLLLLLLLLLLLLLL
L                            L
L                            L
L                            L
L  HHHH                HHHH  L
L  HHHH                HHHH  L
L  HHHH                HHHH  L
L  HHHH                HHHH  L
L          HHHHHHHH          L
L          HHHHHHHH          L
L          HHHHHHHH          L
L          HHHHHHHH          L
L  HHHH                HHHH  L
L  HHHH                HHHH  L
L  HHHH                HHHH  L
L  HHHH                HHHH  L
L                            L
L                            L
L                            L
LLLLLLLLLLLLLLLLLLLLLLLLLLLLLL
