TTTTTTTTTTTTTTTTTTTTTTTTTTTTTT
T                            T
T                            T
T                            T
T  HHHH                HHHH  T
T  HHHH                HHHH  T
T  HHHH                HHHH  T
T  HlHH                HDHH  T
T          HHHHHHH           T
T          HHHHHHH           T
T          HHHHHHH           T
T          HHHDHHH           T
T  HHHH                HHHH  T
T  HHHH                HHHH  T
T  HHHH                HHHH  T
T  HlHH                HDHH  T
T                            T
T                            T
T                            T
TTTTTTTTTTTTTTTTTTTTTTTTTTTTTT
