TTTWWWWWWWWWWWTTTTTTTTTTTTTTTT
TTWWWWWWWWWWW     GGGGTTTTTTTT
TWWWWWWWWWWWK     GGGGTTTTTTTT
WWWWWWWWWWWKK     GGGGTTTTTTTT
WWWWWWWWWWKKK            TTTTT
WWWWWWWWWKKKK              GGT
TWWWWWWW                   GGT
TTWWWWW                    GGT
TTTWWW   GGGGTTT GGGG      GGT
TTTTT    GGGGTTT GGGG      GGT
TTTTT    GGGGTTTTTTTT      GGT
TTTTT    GGGGTTTGGGGG    GGGGT
TTTTT    GGGGTTTGGGGG    GGGGT
TTTTTTTGGGGGGTTTGGGGG    GGGGT
TTTTTTTGGGGGGTTTGGGGG    GGGGT
TTTTTTT      TTT         GGGGT
TGGGG    GGGGTTTKGGGG        T
TGGGG    GGGGTTTKKGGG        T
TGGGG    GGGGTTTKKKGG    1   T
TTTTTTTTSSTTTTTTTTTTTTTTTTTTTT
